XXXXXXXXXXXXXXXXXXXXXXXXXXXXXXXX
X                              X
X                              X
X    XXXXX           XXXX      X
X                              X
X          XXXXXXXX            X
X                              X
X      XXXXXXXXXXXXXXXXX       X
X                              X
X                              X
X  XXXXX                XXXXX  X
X                              X
X       XXXXXXXXXXXXXXXX       X
X                              X
X  XX                      XX  X
X                              X
X    XXX                       X
X      XXXXX       XXXXXXX     X
X                              X
X                              X
X    XXXXXXXXX      XXXXXXXXX  X
X                 XXXX         X
X              XXXXXXXXXX      X
XXXXXXXXXXXXXXXXXXXXXXXXXXXXXXXX